3333333333333333333333333333333333333333
3100000000000000000000000000000400758023
3000000000000000000000000000000000000003
3000000000000000000000000000000200502003
3000000000000000000000000000000000200003
3000000000000000000000000000000000000003
3000000000000000000000000000000000000003
3000000080000000000000000000000000000003
3000000000000000000000000000000000000003
3000000000000000000000000000000000000003
3000000000000000000000000000000000000003
3000000000000000000000000004000000067813
3000000000700000000000000000000000000003
3000000000000000000000000000000000000003
3000000000000000000000000000000000000003
3000000000000000000000000000000000000053
3000000000000600000000000000000000000003
3000000000000000000000000000000000004003
3000000000000000000000000000000000000003
3333333333333333333333333333333333333333
