3333333333333333333333333333333333333333
3400000000000000000000000000000000000043
3030303030303030303003030303030303030303
3000000000000000000000000000000000000003
3030303030303030303003030303030303030303
3000000000000000000000000000000000000003
3030303030303030303003030303030303030303
3000000000000000000000000000000000000003
3030303030303030303003030303030303030303
3000000000000000000000000000000000000003
3000000000000000000000000000000000000003
3030303030303030303003030303030303030303
3000000000000000000000000000000000000003
3030303030303030303003030303030303030303
3000000000000000000000000000000000000003
3030303030303030303003030303030303030303
3000000000000000000000000000000000000003
3030303030303030303003030303030303030303
3400000000000000000000000000000000000043
3333333333333333333333333333333333333333

