3333333333333333333333333333333333333333
3004530000000000000000000000000000758023
3002330000000000000000000000000000000003
3400300000000000000000000000000200502003
3033300000000000000000000000000000200003
3330000000000000000000000000000000000003
3000000000000000000000000000000000000003
3000000080000000000000000000000000000003
3000000000000000000000000000000000000003
3000000000000000000000000000000000000003
3000000000000000000000000000000000000003
3000000000000000000000000004000000067813
3000000000700000000000000000000000000003
3000000000000000000000000000000000000003
3000000000000000000000000000000000000003
3000000000000000000000000000000000000053
3000000000000600000000000000000000000003
3000000000000000000000000000000000004003
3000000000000000000000000000000000000003
3333333333333333333333333333333333333333
