3333333333333333333333333333333333333333
3400020002000200023003200020002000200043
3032303230323032303003032303230323032303
3020202020202020200000020202020202020203
3032303230323032303003032303230323032303
3020002000200020003003000200020002000203
3032303230323032303003032303230323032303
3020202020202020200000020202020202020203
3332303233323032303003032303233323032333
3000000000000000000000000000000000000003
3000000000000000000000000000000000000003
3332303233323032303003032303233323032333
3020202020202020200000020202020202020203
3032303230323032303003032303230323032303
3020002000200020003003000200020002000203
3032303230323032303003032303230323032303
3020202020202020200000020202020202020203
3032303230323032303003032303230323032303
3400020002000200023003200020002000200043
3333333333333333333333333333333333333333
